"Note: Do not change the headings in this file, they are used to detect problems"	
Status Bar Message	Tool Tip
"Segítségért nyomd le az F1 gombot"	
Új térkép	Új térkép
Térkép megnyitása	Térkép megnyitása
A jelenlegi térkép elmentése	Térkép mentése
A jelenlegi térkép elmentése más néven	Térkép mentése másként
"Program információk, verzió szám és szerzõi jogok"	Névjegy
Térkép szerkesztõ bezárása	Kilépés
Súgótémák megjelenítése	Súgótémák
Súgó megjelenítése a jelenlegi feladathoz	Segítség
Ezen térkép megnyitása	
A kiválasztott objektum másolása és vágólapra helyezése	Másolás
A kiválasztott objektum kivágása és vágólapra helyezése	Kivágás
Egy meghatározott típusú objektum keresése	
A vágólap tartalmának beszúrása	Beillesztés
Az utolsó esemény visszavonása	Visszavonás
Az elõzõleg végre nem hajtott feladat megismétlése	Újra
Az ablak méretének megváltoztatása	
Az ablak pozíciójának megváltoztatása	
Az ablak lecsökkentése ikon méretre	
Az ablak nagyítása teljes képernyõre	
Az ablak bezárása	
Ablak visszaállítása a normál méretre	
Az alvilág megtekintése	Alvilág
Térkép bejárhatóságának megmutatása	Bejárhatóság
Terep elhelyezése 	Terep típusok 
Vizek elhelyezése	Folyó típusok
Utak elhelyezése 	Út típusok
Objektumok törlése	Radír
Fölt objektumok elhelyezése	Objektumok föld típusú talajra
Homok objektumok elhelyezése	Objektumok homok típusú talajra
Füves objektumok elhelyezése	Objektumok füves talajra
Havas objektumok elhelyezése	Objektumok havas talajra
Mocsaras objektumok elhelyezése	Objektumok mocsaras talajra
Törmelékes objektumok elhelyezése	Objektumok törmelékes talajra
Föld alatti objektumok elhelyezése	Objektumok föld alatti talajra
Lávás objektumok elhelyezése	Objektumok lávás talajra
Vízi objektumok elhelyezése	Objektumok vízi talajra
Városok elhelyezése	Városok
Lények elhelyezése	Lények
Hõsök elhelyezése	Hõsök
Varázstárgyak elhelyezése	Varázstárgyak
Kincsek elhelyezése	Kincsek
Objektumok animálása a térképen	
A térkép leírásának módosítása	
Az 1x1-es ecset kiválasztása	1x1-es ecset
A 2x2-es ecset kiválasztása	2x2-es ecset
A 4x4-es ecset kiválasztása	4x4-es ecset
Kerületes ecset kiválasztása	Kerületes ecset
Föld típusú terep kiválasztása	Föld
Homok típusú terep kiválasztása	Homok
Fû típusú terep kiválasztása	Fû
Hó típusú terep kiválasztása	Hó
Mocsár típusú terep kiválasztása	Mocsár
Törmelék típusú terep kiválasztása	Törmelék
Föld alatti típusú terep kiválasztása	Föld alatti
Láva típusú terep kiválasztása	Láva
Víz típusú terep kiválasztása	Víz
Folyó törlése 	Folyók törlése
Jeges víz kiválasztása 	Jeges víz
Üledékes víz kiválasztása  	Üledékes víz
Láva folyam kiválasztása   	Láva folyam
A kavicsolt közút úttípus kiválasztása	Kavicsolt közút
A kõvel kirakott típusú út kiválasztása	Kõvel kirakott utak
Az 1x1-es ecset kiválasztása	1x1-es ecset
A 2x2-es ecset kiválasztása	2x2-es ecset
A 4x4-es ecset kiválasztása	4x4-es ecset
Kerületes ecset kiválasztása	Kerületes ecset
Semleges játékos beállítása	
A %s játékos kiválasztása	
Földút kiválasztása	Földút
Sziklás terep kiválasztása	Szikla
A kiválasztott objektum törlése	Törlés
A kiválasztott objektum tulajdonságainak megtekintése	Tulajdonságok
Háló bekapcsolása	Haló
Az összes objektum megjelenítése 	Összes objektum
Az 1x1-es ecset kiválasztása	1x1-es ecset
A 2x2-es ecset kiválasztása	2x2-es ecset
A 4x4-es ecset kiválasztása	4x4-es ecset
Kerületes ecset kiválasztása	Kerületes ecset
A térképen elõfordulható hibák ellenõrzése	Térkép ellenõrzése
A térkép elemeinek animálása	
A program beállításainak módosítása	
A jelenlegi térkép szövegeinek exportálása egy szöveges fájlba	
Egy szöveges fájl importálása a jelenlegi térképbe	
A kiválasztott objektum leírása	
Az utoljára megadott típusú objektum keresése
Az utoljára megadott típusú objektum keresése -visszafelé	
Távolítás a térképen	Távolít
Közelítés a térképen	Közelít
Az eszköztár megjelenítése vagy elrejtése 	Eszköztár kapcsoló
Az állapotsor megjelenítése vagy elrejtése	Állapotsor kapcsoló
Térkép elemek megjelenítése vagy elrejtése	Térkép elemek kapcsoló